{
  "name": "Iris CE Rev. 1",
  "vendorProductId": 3406828886,
  "macros": [
    "LSFT_T(KC_UNDS)",
    "",
    "",
    "",
    "",
    "",
    "",
    "",
    "",
    "",
    "",
    "",
    "",
    "",
    "",
    ""
  ],
  "layers": [
    [
      "KC_GRV",
      "KC_1",
      "KC_2",
      "KC_3",
      "KC_4",
      "KC_5",
      "KC_TAB",
      "KC_Q",
      "KC_W",
      "KC_E",
      "KC_R",
      "KC_T",
      "KC_GESC",
      "KC_A",
      "KC_S",
      "KC_D",
      "KC_F",
      "KC_G",
      "KC_LGUI",
      "KC_Z",
      "KC_X",
      "KC_C",
      "KC_V",
      "KC_B",
      "KC_NO",
      "KC_NO",
      "FN_MO13",
      "KC_LSPO",
      "KC_SPC",
      "S(KC_MINS)",
      "KC_BSPC",
      "KC_0",
      "KC_9",
      "KC_8",
      "KC_7",
      "KC_6",
      "KC_BSLS",
      "KC_P",
      "KC_O",
      "KC_I",
      "KC_U",
      "KC_Y",
      "KC_QUOT",
      "KC_SCLN",
      "KC_L",
      "KC_K",
      "KC_J",
      "KC_H",
      "KC_RALT",
      "KC_SLSH",
      "KC_DOT",
      "KC_COMM",
      "KC_M",
      "KC_N",
      "KC_NO",
      "KC_NO",
      "FN_MO23",
      "KC_RCPC",
      "KC_SFTENT",
      "KC_EQL"
    ],
    [
      "S(KC_GRV)",
      "S(KC_1)",
      "S(KC_2)",
      "S(KC_3)",
      "S(KC_4)",
      "S(KC_5)",
      "KC_GRV",
      "KC_TRNS",
      "KC_UP",
      "KC_TRNS",
      "KC_TRNS",
      "KC_TRNS",
      "KC_TRNS",
      "KC_LEFT",
      "KC_DOWN",
      "KC_RGHT",
      "S(KC_9)",
      "KC_TRNS",
      "KC_TRNS",
      "KC_TRNS",
      "KC_TRNS",
      "KC_LBRC",
      "S(KC_LBRC)",
      "KC_TRNS",
      "KC_NO",
      "KC_NO",
      "KC_TRNS",
      "KC_TRNS",
      "KC_DEL",
      "KC_TRNS",
      "KC_PGUP",
      "S(KC_0)",
      "S(KC_9)",
      "S(KC_8)",
      "S(KC_7)",
      "S(KC_6)",
      "KC_PGDN",
      "KC_TRNS",
      "KC_TRNS",
      "KC_TRNS",
      "KC_TRNS",
      "KC_TRNS",
      "S(KC_BSLS)",
      "S(KC_EQL)",
      "KC_TRNS",
      "KC_TRNS",
      "S(KC_0)",
      "KC_TRNS",
      "KC_TRNS",
      "KC_MINS",
      "KC_TRNS",
      "KC_RBRC",
      "S(KC_RBRC)",
      "KC_TRNS",
      "LAG(KC_ESC)",
      "KC_NO",
      "KC_LSFT",
      "KC_TRNS",
      "KC_DEL",
      "KC_TRNS"
    ],
    [
      "KC_F12",
      "KC_F1",
      "KC_F2",
      "KC_F3",
      "KC_F4",
      "KC_F5",
      "RGB_TOG",
      "S(KC_1)",
      "S(KC_2)",
      "S(KC_3)",
      "S(KC_4)",
      "S(KC_5)",
      "RGB_MOD",
      "KC_MPRV",
      "KC_MNXT",
      "KC_VOLU",
      "S(KC_MINS)",
      "KC_TRNS",
      "RGB_RMOD",
      "KC_MSTP",
      "KC_MPLY",
      "KC_VOLD",
      "KC_MINS",
      "KC_TRNS",
      "KC_NO",
      "KC_NO",
      "KC_MUTE",
      "KC_MNXT",
      "KC_VOLU",
      "KC_TRNS",
      "KC_F11",
      "KC_F10",
      "KC_F9",
      "KC_F8",
      "KC_F7",
      "KC_F6",
      "RESET",
      "S(KC_0)",
      "S(KC_9)",
      "S(KC_8)",
      "S(KC_7)",
      "S(KC_6)",
      "KC_BSLS",
      "KC_TRNS",
      "KC_TRNS",
      "KC_PGUP",
      "KC_EQL",
      "KC_TRNS",
      "KC_TRNS",
      "KC_TRNS",
      "KC_TRNS",
      "KC_PGDN",
      "S(KC_EQL)",
      "KC_TRNS",
      "KC_NO",
      "KC_NO",
      "KC_TRNS",
      "KC_MPRV",
      "KC_VOLD",
      "KC_TRNS"
    ],
    [
      "KC_TRNS",
      "KC_TRNS",
      "KC_TRNS",
      "KC_TRNS",
      "KC_TRNS",
      "KC_TRNS",
      "KC_TRNS",
      "KC_TRNS",
      "KC_TRNS",
      "KC_TRNS",
      "KC_TRNS",
      "KC_TRNS",
      "KC_TRNS",
      "KC_TRNS",
      "KC_TRNS",
      "KC_TRNS",
      "KC_TRNS",
      "KC_TRNS",
      "KC_TRNS",
      "KC_TRNS",
      "KC_TRNS",
      "KC_TRNS",
      "KC_TRNS",
      "KC_TRNS",
      "KC_TRNS",
      "KC_TRNS",
      "KC_TRNS",
      "KC_TRNS",
      "KC_TRNS",
      "KC_TRNS",
      "KC_TRNS",
      "KC_TRNS",
      "KC_TRNS",
      "KC_TRNS",
      "KC_TRNS",
      "KC_TRNS",
      "KC_TRNS",
      "KC_TRNS",
      "KC_TRNS",
      "KC_TRNS",
      "KC_TRNS",
      "KC_TRNS",
      "KC_TRNS",
      "KC_TRNS",
      "KC_TRNS",
      "KC_TRNS",
      "KC_TRNS",
      "KC_TRNS",
      "KC_TRNS",
      "KC_TRNS",
      "KC_TRNS",
      "KC_TRNS",
      "KC_TRNS",
      "KC_TRNS",
      "KC_TRNS",
      "KC_TRNS",
      "KC_TRNS",
      "KC_TRNS",
      "KC_TRNS",
      "KC_TRNS"
    ]
  ],
  "encoders": []
}